11111111111111111111111
11101111101111111111111
1111C111C11111111111111
11100000001111111111111
11001000100111111111111
10000000000011111111111
101000000010101111101P1
10101111101C11011101101
1E110010011010000000101
11111111111000100010001
11111111111C00000000001
11111111111100000000C11
11111111111110111110111
11111111111101111111011
11111111111111111111111
