1111111111111
1110111110111
1111C111C1111
111000P000111
1100100010011
1C000000000C1
101000E000101
1010111110101
1011001001101
1111111111111
